        111 
      11   11 
    11       11 
  111    x     111
    11       11
      11   11 
        111    

  s1s1s1s1s1s1s1s1