    
    1          1
   1y1        1y1
  1   1      1   1
 1     1    1     1
1x      1ii1x      1
1      x1ii1      x1
 1     1    1     1
  1   1      1   1
   1y1        1y1
    1          1