
  111   111  11111 
 1   1 1   1 1    1 
 1   1 1   1 1 y  1
 1   1 1   1 1 x  1
 1   1 1   1 1    1
 1 y 1 1 b 1 1    1
 1 x 1 1   1 11111 
 1   1 1   1 1  
 1   1 1   1 1     
 1   1 1   1 1 
 1   1 1   1 1
 1   1 1   1 1 
  111   111  1

s323232323232323232s