   1  1  1  1  1
  3             3
  1    i 1 i    1 
       1 b 1     
  1    i 1 i    1
  3             3 
   1  1  1  1  1
 
2      2    2      2